WE ./textures/west.xpm
NO ./textures/north.xpm
EA ./textures/east.xpm
SO ./textures/south.xpm
D ./textures/door.xpm

C 200,110,155
F 255,100,055


        1111111111111111111111111
        10000000001D0000000000001
        1011000001110000000000001
        100100000DDD000000W000001
111111111011000001110000000000001
10000000001100000111111111D111111
1111D111111111D11100000010001
1111D111111111D111000000D0001
11000000110101D11100000010001
1000000000000000DD00000010001
10000000000000001100000010001             1
110000011101010111111111100011111        101
11110111 1110101 101111010001             1
11111111 1111111 111111111111