WE ./textures/rendu/WEST.xpm
NO ./textures/rendu/NORTH.xpm
EA ./textures/rendu/EAST.xpm
SO ./textures/rendu/SOUTH.xpm

      
     
       F 255,248,220
C 135,206,250


111111111111
100000000001
100000000001111111
100000N00000000001
100000000001111111
100000000001
111111111111