WE ./textures/west.xpm
NO ./textures/north.xpm
EA ./textures/east.xpm
SO ./textures/south.xpm



C 200,110,155
F 255,100,055


        1111111111111111111111111
        1000000000110000000000001
        1011000001110000000000001
        1001000000000000000000001
111111111011000001110000000000001
100000000011000001110111111111111
11110111111111011100000010001
11110111111111011101010010001
110000001101010111000E1010001
10000000000000001100010010001
10000000000000001101010010001             1
110000011101010111110111100011111        101
11110111 1110101 101111010001             1
11111111 1111111 111111111111