
NO ./textures/north.xpm
EA ./textures/east.xpm
SO ./textures/south.xpm
WE ./textures/west.xpm


C 135,206,250
F 255,248,220

        1111111111111111111111111
        1000000000100000000000001      
        10110000011100  000000001
        1001000000000000W0000001
111111111011000001110000000000001
100000000011000001111111110111111
11110111111111011100000010001
11110111111111011100000000001
11000000110101011100000010001
1000000000000000000000010001
10000000000000001100000010001             1
110000011101010111111111100011111        101
11110111 1110101 101111010001             1
11111111 1111111 111111111111