WE ./textures/west.xpm
NO ./textures/north.xpm
EA ./textures/east.xpm
SO ./textures/south.xpm


F 255,248,220
C 135,206,250


111111111111
100000000001
10000S000001
1000E0N00001
10000W000001
100000000001
111111111111