WE ./textures/west.xpm
NO ./textures/north.xpm
EA ./textures/east.xpm
SO ./textures/souts.xpm
D ./textures/door.xpm


C 200,110,155
F 255,100,055


        1111111111111111111111111
        1000000000110000000000001
        1011000001110000000000001
        1001000000000000000000001
111111111011000001110000000000001
100000000011000001111111111111111
11110111111111011100000010001
11110111111111011100000010001
11000000110101011100000010001
10000000000000001100000010001
10000000000000001100000010001             1
110000011101010111111111100011111        1W1
11110111 1110101 101111010001             1
11111111 1111111 111111111111